103 103 103 103 103 103 103 103 103 103 103 103 103 103 103 103 103 103 103 103 103 103 103 103 103 103 103 103 103 103
103 1 0 0 0 0 0 0 0 103 103 103 103 103 103 103 103 103 103 103 0 0 0 0 120 0 0 0 0 103
103 0 102 102 102 102 0 0 0 0 0 0 120 0 0 110 0 0 120 0 0 0 0 0 102 102 330 330 0 103
103 0 102 102 102 102 0 0 0 0 0 110 120 0 120 110 0 110 120 0 0 0 0 0 102 102 102 330 0 103
103 0 102 102 0 0 0 0 0 0 120 110 120 110 120 110 120 110 120 0 0 0 0 0 0 0 102 102 0 103
103 0 102 102 0 0 0 0 0 0 120 110 120 110 120 110 120 110 120 0 0 0 0 0 0 0 102 102 0 103
103 0 0 0 0 0 0 302 0 0 120 110 120 110 120 110 120 110 120 0 0 0 0 0 0 0 120 0 0 103
103 102 102 102 0 0 0 302 0 0 120 110 0 110 120 0 120 110 0 0 0 0 0 302 0 0 102 102 102 103
103 334 334 101 0 0 0 302 0 0 120 0 0 110 0 0 120 0 0 0 0 0 0 302 0 0 101 331 331 103
103 102 102 102 0 0 0 302 0 300 301 301 301 301 301 301 301 301 301 300 0 0 0 302 0 0 102 102 102 103
103 0 0 0 0 0 0 302 0 302 103 103 103 103 103 103 103 103 103 302 0 0 0 302 0 0 0 0 0 103
103 102 102 102 0 0 0 302 0 302 103 103 103 103 103 103 103 103 103 302 0 0 0 302 0 0 102 102 102 103
103 335 335 101 0 0 0 302 0 302 103 103 103 103 103 103 103 103 103 302 0 0 0 302 0 0 101 336 336 103
103 102 102 102 0 302 0 302 0 302 103 103 103 300 301 300 103 103 103 302 0 0 0 302 0 0 102 102 102 103
103 0 0 0 0 302 0 302 0 302 103 103 103 302 200-5 302 103 103 103 302 0 0 0 302 0 0 0 0 0 103
103 0 0 0 0 302 0 0 0 302 103 103 103 302 200-5 302 103 103 103 302 0 302 0 302 0 0 0 0 0 103
103 102 102 102 0 302 0 0 0 302 103 103 103 300 301 300 103 103 103 302 0 302 0 302 0 0 102 102 102 103
103 336 336 101 0 302 0 0 0 302 103 103 103 103 103 103 103 103 103 302 0 302 0 0 0 0 101 335 335 103
103 102 102 102 0 302 0 0 0 302 103 103 103 103 103 103 103 103 103 302 0 302 0 0 0 0 102 102 102 103
103 0 0 0 0 302 0 0 0 302 103 103 103 103 103 103 103 103 103 302 0 302 0 0 0 0 0 0 0 103
103 102 102 102 0 302 0 0 0 300 301 301 301 301 301 301 301 301 301 300 0 302 0 0 0 0 102 102 102 103
103 331 331 101 0 302 0 0 0 0 110 0 0 120 0 0 110 0 0 0 0 302 0 0 0 0 101 334 334 103
103 102 102 102 0 302 0 0 0 0 110 120 0 120 110 0 110 120 0 0 0 302 0 0 0 0 102 102 102 103
103 0 0 110 0 0 0 0 0 0 110 120 110 120 110 120 110 120 110 0 0 302 0 0 0 0 0 0 0 103
103 0 102 102 0 0 0 0 0 0 110 120 110 120 110 120 110 120 110 0 0 0 0 0 0 0 102 102 0 103
103 0 102 102 0 0 0 0 0 0 110 120 110 120 110 120 110 120 110 0 0 0 0 0 0 0 102 102 0 103
103 0 330 102 102 102 0 0 0 0 0 120 110 0 110 120 0 120 110 0 0 0 0 0 102 102 102 102 0 103
103 0 330 330 102 102 0 0 0 0 0 0 110 0 0 120 0 0 110 0 0 0 0 0 102 102 102 102 0 103
103 0 0 0 0 110 0 0 0 103 103 103 103 103 103 103 103 103 103 103 0 0 0 0 0 0 0 0 2 103
103 103 103 103 103 103 103 103 103 103 103 103 103 103 103 103 103 103 103 103 103 103 103 103 103 103 103 103 103 103
