102 102 102 102 102 102 102 102 102 102 102
102 1 0 100 0 100 0 100 0 100 102
102 0 102 0 102 0 102 0 102 0 102
102 100 0 100 0 100 0 100 0 100 102
102 0 102 0 102 0 102 0 102 0 102
102 100 0 100 0 100 0 100 0 100 102
102 0 102 0 102 0 102 0 102 0 102
102 100 0 100 0 100 0 100 0 100 102
102 0 102 0 102 0 102 0 102 0 102
102 100 0 100 0 100 0 100 0 100 102
102 0 102 0 102 0 102 0 102 0 102
102 100 0 100 0 100 0 100 0 2 102
102 102 102 102 102 102 102 102 102 102 102
