102 102 102 102 102 102 102 102 102 102 102
102 1 0 0 0 0 0 0 0 0 102
102 100 102 100 102 100 102 100 102 100 102
102 100 100 100 100 100 100 100 100 100 102
102 102 100 100 100 102 100 100 100 102 102
102 102 102 100 100 100 100 100 102 102 102
102 102 102 102 100 100 100 102 102 102 102
102 102 102 102 102 100 102 102 102 102 102
102 102 102 102 100 100 100 102 102 102 102
102 102 102 100 100 102 100 100 102 102 102
102 102 100 100 100 100 100 100 100 102 102
102 100 100 100 100 100 100 100 100 100 102
102 100 102 100 102 100 102 100 102 100 102
102 0 0 0 0 0 0 0 0 2 102
102 102 102 102 102 102 102 102 102 102 102
