201-5,22 102 102 102 102 102 102 102 102 102 102 102 102 102 102 102 102 102 102 102 102 102 102 102 102 102 102 102 102 102 102 102 102 102 102 102 102 102 102 102 102 103 0 0 0 0 0 0 304-59,22 103 102 102 102 102 102 102 102 102 102 102 102 102 201-4,22
102 102 102 102 102 102 102 102 100 100 100 100 100 100 100 100 100 100 100 100 100 100 100 102 102 102 0 100 100 100 100 100 100 100 100 100 0 102 102 102 102 102 103 336 103 335 103 334 103 102 102 102 102 102 303-3 102 102 102 102 102 102 102 102
102 102 102 100 304-11,37 102 102 102 0 0 0 0 0 0 0 0 0 0 0 0 0 0 0 110 110 110 0 100 100 100 100 100 100 100 100 100 0 102 102 102 102 102 102 103 102 103 102 103 102 102 102 102 102 102 110 102 102 102 304-51,11 100 102 102 102
102 102 100 100 0 102 201-2,2 102 0 0 0 0 0 0 0 0 0 0 0 0 0 0 0 102 102 102 0 0 0 0 0 0 0 0 0 0 0 102 102 102 102 102 102 102 102 102 102 102 102 102 102 102 102 102 0 120 120 120 0 100 100 102 102
102 100 100 0 0 102 201-2,2 102 0 102 0 0 0 102 102 102 102 102 102 102 102 102 102 102 102 102 102 102 102 102 110 110 110 102 102 102 102 102 102 102 102 102 102 102 102 102 102 102 102 102 102 102 102 102 0 120 120 120 0 0 100 100 102
102 100 0 0 0 102 201-2,2 102 0 102 0 0 0 102 0 0 0 0 0 0 0 0 0 102 102 102 0 0 0 0 0 0 0 0 0 0 0 102 102 102 0 0 0 0 0 0 0 0 0 102 103 103 103 102 0 120 120 120 0 0 0 100 102
102 0 0 0 0 102 102 102 0 102 0 0 0 102 0 0 120 0 0 0 0 102 102 102 102 102 102 102 0 0 0 0 0 0 0 102 102 102 102 102 102 102 120 120 0 0 0 200-2 0 102 103 304-58,41 103 102 0 102 102 102 0 0 0 0 102
102 0 0 0 0 102 102 102 0 102 0 0 0 102 0 120 1 0 0 0 0 110 304-27,7 102 102 102 304-21,7 110 0 0 0 0 0 0 0 110 304-41,7 102 102 102 304-35,7 110 0 120 0 0 200-2 0 0 102 103 0 103 102 0 102 102 102 0 0 0 0 102
102 0 0 0 0 102 102 102 0 102 0 0 0 102 0 0 0 0 120 120 120 102 102 102 201-1,4 102 102 102 0 0 0 0 0 0 0 102 102 102 201-1,4 102 102 102 0 120 0 200-2 0 0 0 102 103 330 103 102 0 102 102 102 0 0 0 0 102
102 0 0 0 0 102 102 102 0 102 0 0 0 102 0 0 0 120 120 200-2 0 0 0 102 102 102 0 0 0 200-2 0 200-2 0 200-2 0 0 0 102 102 102 0 0 0 120 200-2 0 0 0 0 102 103 331 103 102 0 102 102 102 0 0 0 0 102
102 0 0 0 0 102 102 102 0 102 0 0 0 102 0 0 0 120 200-2 110 110 102 102 102 201-1,4 102 102 102 0 0 0 0 0 0 0 102 102 102 201-1,4 102 102 102 0 102 110 110 110 110 0 102 103 330 103 102 0 102 102 102 0 0 0 0 102
102 0 0 0 0 102 102 102 0 102 0 0 0 102 0 0 0 120 0 110 0 120 304-27,11 102 102 102 304-21,11 120 0 0 0 0 0 0 0 120 304-41,11 102 102 102 304-35,11 120 0 0 0 0 0 110 0 102 103 0 103 102 0 102 102 102 0 0 0 0 102
102 0 0 0 0 102 102 102 0 102 0 0 0 102 0 102 110 102 0 102 120 102 102 102 102 102 102 102 0 0 0 0 0 0 0 102 102 102 102 102 102 102 110 102 0 102 120 102 0 102 103 304-58,3 103 102 0 102 102 102 0 0 0 0 102
102 0 0 0 0 102 102 102 0 102 0 0 0 102 0 102 304-16,18 102 0 102 304-20,18 102 102 102 102 102 0 0 0 0 0 0 0 0 0 0 0 102 102 102 102 102 304-42,18 102 0 102 304-46,18 102 0 102 103 103 103 102 0 102 102 102 0 0 0 0 102
102 0 0 0 0 102 102 102 0 102 102 110 102 102 102 102 102 102 102 102 102 102 102 102 102 102 102 102 102 102 102 102 102 102 102 102 102 102 102 102 102 102 102 102 102 102 102 102 102 102 102 102 102 102 0 102 102 102 0 0 0 0 102
102 0 0 0 0 102 102 102 0 102 102 110 102 102 102 102 102 201-1,4 102 201-1,4 102 102 102 102 102 102 102 102 102 102 102 102 102 102 102 102 102 102 102 102 102 102 102 201-1,4 102 201-1,4 102 102 102 102 102 102 102 102 0 102 102 102 0 0 0 0 102
102 0 0 0 0 102 102 102 0 102 102 110 102 102 102 102 102 102 102 102 102 102 102 102 102 102 102 102 102 102 102 102 102 102 102 102 102 102 102 102 102 102 102 102 102 102 102 102 102 102 102 102 102 102 0 102 102 102 0 0 0 0 102
102 0 0 0 0 102 102 102 0 102 0 0 0 102 0 102 304-16,12 102 0 102 304-20,12 102 0 102 102 102 102 102 102 102 102 102 102 102 102 102 102 102 102 102 0 102 304-42,12 102 0 102 304-46,12 102 0 102 0 0 0 102 0 102 102 102 0 0 0 0 102
102 0 0 0 0 102 102 102 0 102 100 100 0 102 0 102 110 102 0 102 120 102 0 102 102 102 102 0 0 0 0 0 0 0 0 0 102 102 102 102 0 102 110 102 0 102 120 102 0 102 0 100 100 102 0 102 102 102 0 0 0 0 102
102 102 0 0 0 102 102 102 0 102 100 100 0 102 0 0 0 0 0 0 0 0 0 102 102 102 102 0 200-2 0 120 200-2 110 0 200-2 0 102 102 102 102 0 0 0 0 0 0 0 0 0 102 0 100 100 102 0 102 102 102 0 0 0 102 102
102 102 102 0 0 102 102 102 0 102 100 100 0 102 0 0 0 0 200-2 0 0 0 0 102 102 102 102 0 0 120 120 0 110 110 0 0 102 102 102 102 0 0 0 0 200-2 0 0 0 0 102 0 100 100 102 0 102 102 102 0 0 102 102 102
102 200-2 102 0 0 102 102 102 0 102 100 100 0 110 0 0 0 0 0 0 0 0 0 102 102 102 102 0 201-0,2 110 201-0,2 0 201-0,2 120 201-0,2 0 102 102 102 102 0 0 0 0 0 0 0 0 0 120 0 100 100 102 0 102 102 102 0 0 102 200-2 102
304-59,22 303-5 120 0 0 102 102 102 0 102 100 100 0 110 0 0 0 0 200-2 0 0 0 0 102 102 102 102 0 110 304-20,44 110 303-1 120 304-42,0 120 0 102 102 102 102 0 0 0 0 200-2 0 0 0 0 120 0 100 100 102 0 102 102 102 0 0 110 303-4 304-3,22
102 200-2 102 0 0 102 102 102 0 102 100 100 0 110 0 0 0 0 0 0 0 0 0 102 102 102 102 0 201-0,2 110 201-0,2 0 201-0,2 120 201-0,2 0 102 102 102 102 0 0 0 0 0 0 0 0 0 120 0 100 100 102 0 102 102 102 0 0 102 200-2 102
102 102 102 0 0 102 102 102 0 102 100 100 0 102 0 0 0 0 200-2 0 0 0 0 102 102 102 102 0 0 120 120 0 110 110 0 0 102 102 102 102 0 0 0 0 200-2 0 0 0 0 102 0 100 100 102 0 102 102 102 0 0 102 102 102
102 102 0 0 0 102 102 102 0 102 100 100 0 102 0 0 0 0 0 0 0 0 0 102 102 102 102 0 200-2 0 120 200-2 110 0 200-2 0 102 102 102 102 0 0 0 0 0 0 0 0 0 102 0 100 100 102 0 102 102 102 0 0 0 102 102
102 0 0 0 0 102 102 102 0 102 100 100 0 102 0 102 110 102 0 102 120 102 0 102 102 102 102 0 0 0 0 0 0 0 0 0 102 102 102 102 0 102 110 102 0 102 120 102 0 102 0 100 100 102 0 102 102 102 0 0 0 0 102
102 0 0 0 0 102 102 102 0 102 0 0 0 102 0 102 304-16,32 102 0 102 304-20,32 102 0 102 102 102 102 102 102 102 102 102 102 102 102 102 102 102 102 102 0 102 304-42,32 102 0 102 304-46,32 102 0 102 0 0 0 102 0 102 102 102 0 0 0 0 102
102 0 0 0 0 102 102 102 0 102 102 102 102 102 102 102 102 102 102 102 102 102 102 102 102 102 102 102 102 102 102 102 102 102 102 102 102 102 102 102 102 102 102 102 102 102 102 102 102 102 102 120 102 102 0 102 102 102 0 0 0 0 102
102 0 0 0 0 102 102 102 0 102 102 102 102 102 102 102 102 201-1,4 102 201-1,4 102 102 102 102 102 102 102 102 102 102 102 102 102 102 102 102 102 102 102 102 102 102 102 201-1,4 102 201-1,4 102 102 102 102 102 120 102 102 0 102 102 102 0 0 0 0 102
102 0 0 0 0 102 102 102 0 102 102 102 102 102 102 102 102 102 102 102 102 102 102 102 102 102 102 102 102 102 102 102 102 102 102 102 102 102 102 102 102 102 102 102 102 102 102 102 102 102 102 120 102 102 0 102 102 102 0 0 0 0 102
102 0 0 0 0 102 102 102 0 102 103 103 103 102 0 102 304-16,26 102 0 102 304-20,26 102 102 102 102 102 0 0 0 0 0 0 0 0 0 0 0 102 102 102 102 102 304-42,26 102 0 102 304-46,26 102 0 102 0 0 0 102 0 102 102 102 0 0 0 0 102
102 0 0 0 0 102 102 102 0 102 103 304-4,41 103 102 0 102 110 102 0 102 120 102 102 102 102 102 102 102 0 0 0 0 0 0 0 102 102 102 102 102 102 102 110 102 0 102 120 102 0 102 0 0 0 102 0 102 102 102 0 0 0 0 102
102 0 0 0 0 102 102 102 0 102 103 0 103 102 0 120 0 0 0 0 0 110 304-27,33 102 102 102 304-21,33 110 0 0 0 0 0 0 0 110 304-41,33 102 102 102 304-35,33 110 0 120 0 110 0 0 0 102 0 0 0 102 0 102 102 102 0 0 0 0 102
102 0 0 0 0 102 102 102 0 102 103 330 103 102 0 120 120 120 120 102 0 102 102 102 201-1,4 102 102 102 0 0 0 0 0 0 0 102 102 102 201-1,4 102 102 102 120 120 200-2 110 0 0 0 102 0 0 0 102 0 102 102 102 0 0 0 0 102
102 0 0 0 0 102 102 102 0 102 103 331 103 102 0 0 0 0 200-2 110 0 0 0 102 102 102 0 0 0 200-2 0 200-2 0 200-2 0 0 0 102 102 102 0 0 0 200-2 110 110 0 0 0 102 0 0 0 102 0 102 102 102 0 0 0 0 102
102 0 0 0 0 102 102 102 0 102 103 330 103 102 0 0 0 200-2 0 110 0 102 102 102 201-1,4 102 102 102 0 0 0 0 0 0 0 102 102 102 201-1,4 102 102 102 110 110 110 0 0 0 0 102 0 0 0 102 0 102 102 102 0 0 0 0 102
102 0 0 0 0 102 102 102 0 102 103 0 103 102 0 0 200-2 0 0 110 0 120 304-27,37 102 102 102 304-21,37 120 0 0 0 0 0 0 0 120 304-41,37 102 102 102 304-35,37 120 0 0 0 0 2 110 0 102 0 0 0 102 0 102 102 102 0 0 0 0 102
102 0 0 0 0 102 102 102 0 102 103 304-4,3 103 102 0 200-2 0 0 0 110 110 102 102 102 102 102 102 102 0 0 0 0 0 0 0 102 102 102 102 102 102 102 0 0 0 0 110 0 0 102 0 0 0 102 0 102 102 102 0 0 0 0 102
102 100 0 0 0 110 110 110 0 102 103 103 103 102 0 0 0 0 0 0 0 0 0 102 102 102 0 0 0 0 0 0 0 0 0 0 0 102 102 102 0 0 0 0 0 0 0 0 0 102 0 0 0 102 0 102 201-3,2 102 0 0 0 100 102
102 100 100 0 0 110 110 110 0 102 102 102 102 102 102 102 102 102 102 102 102 102 102 102 102 102 102 102 102 102 120 120 120 102 102 102 102 102 102 102 102 102 102 102 102 102 102 102 102 102 0 0 0 102 0 102 201-3,2 102 0 0 100 100 102
102 102 100 100 0 110 110 110 0 102 102 102 102 102 102 102 102 102 102 102 102 102 102 102 102 102 0 0 0 0 0 0 0 0 0 0 0 102 102 102 0 0 0 0 0 0 0 0 0 0 0 0 0 0 0 102 201-3,2 102 0 100 100 102 102
102 102 102 100 304-11,33 102 102 102 120 102 102 102 102 102 102 103 102 103 102 103 102 102 102 102 102 102 0 100 100 100 100 100 100 100 100 100 0 120 120 120 0 0 0 0 0 0 0 0 0 0 0 0 0 0 0 102 102 102 304-51,7 100 102 102 102
102 102 102 102 102 102 102 102 303-2 102 102 102 102 102 103 334 103 335 103 336 103 102 102 102 102 102 0 100 100 100 100 100 100 100 100 100 0 102 102 102 100 100 100 100 100 100 100 100 100 100 100 100 100 100 100 102 102 102 102 102 102 102 102
201-5,22 102 102 102 102 102 102 102 102 102 102 102 102 103 304-62,22 0 0 0 0 0 0 103 102 102 102 102 102 102 102 102 102 102 102 102 102 102 102 102 102 102 102 102 102 102 102 102 102 102 102 102 102 102 102 102 102 102 102 102 102 102 102 102 201-4,22
