102 102 102 102 102 102 102 102 102 102 102 102 102 102 102 102 102 102 102 102 102 102 102 102 102 102 102 102 102 102
102 100 100 100 100 100 100 100 100 100 100 100 100 100 100 100 100 100 100 100 100 100 100 100 100 100 100 100 100 102
102 100 0 0 0 0 0 0 0 0 0 0 0 0 0 0 0 0 0 0 0 0 0 0 0 0 0 0 100 102
102 100 0 102 102 102 102 102 102 102 102 102 102 102 102 102 102 102 102 102 102 102 102 102 102 102 102 0 100 102
102 100 0 102 0 0 0 0 0 0 0 0 0 0 0 0 0 0 0 0 0 0 0 0 0 0 102 0 100 102
102 100 0 102 0 100 100 100 100 0 102 100 102 0 100 100 100 100 100 100 100 100 0 100 100 0 102 0 100 102
102 100 0 102 0 100 100 100 100 0 102 100 102 0 100 100 100 100 100 100 100 100 0 100 100 0 102 0 100 102
102 100 0 102 0 100 100 0 0 0 102 100 102 0 0 0 0 0 0 0 0 0 0 100 100 0 102 0 100 102
102 100 0 102 0 100 100 0 102 102 102 100 102 102 102 102 102 102 102 102 102 102 0 100 100 0 102 0 100 102
102 100 0 102 0 100 100 0 102 102 102 100 102 102 102 102 102 102 102 102 102 102 0 100 100 0 102 0 100 102
102 100 0 102 0 100 100 0 102 102 102 100 102 102 102 102 102 102 102 102 102 102 0 100 100 0 102 0 100 102
102 100 0 102 0 100 100 0 102 102 102 1 0 0 0 0 0 0 0 102 102 102 0 100 100 0 102 0 100 102
102 100 0 102 0 100 100 0 102 102 102 0 0 0 0 0 0 0 0 102 102 102 0 100 100 0 102 0 100 102
102 100 0 102 110 110 110 110 102 102 102 0 0 101 101 101 101 0 0 102 102 102 110 110 110 110 102 0 100 102
102 100 0 0 0 0 0 0 102 102 102 0 0 101 200-2 200-2 101 0 0 102 102 102 0 0 0 0 0 0 100 102
102 100 0 200-2 0 0 200-2 0 102 102 102 0 0 101 200-2 200-2 101 0 0 102 102 102 0 200-2 0 0 200-2 0 100 102
102 100 0 0 0 0 0 0 102 102 102 0 0 101 200-2 200-2 101 0 0 102 102 102 0 0 0 0 0 0 100 102
102 102 102 102 102 102 102 102 102 102 102 0 0 101 200-2 200-2 101 0 0 102 102 102 102 102 102 102 102 102 102 102
102 102 102 102 102 102 102 102 102 102 102 0 0 101 200-2 200-2 101 0 0 102 102 102 102 102 102 102 102 102 102 102
102 102 102 102 102 102 102 102 102 102 102 0 0 101 200-2 200-2 101 0 0 102 102 102 102 102 102 102 102 102 102 102
102 100 0 0 0 0 0 0 102 102 102 0 0 101 200-2 200-2 101 0 0 102 102 102 0 0 0 0 0 0 100 102
102 100 0 200-2 0 0 200-2 0 102 102 102 0 0 101 200-2 200-2 101 0 0 102 102 102 0 200-2 0 0 200-2 0 100 102
102 100 0 0 0 0 0 0 102 102 102 0 0 101 200-2 200-2 101 0 0 102 102 102 0 0 0 0 0 0 100 102
102 100 0 102 120 120 120 120 102 102 102 0 0 101 101 101 101 0 0 102 102 102 120 120 120 120 102 0 100 102
102 100 0 102 0 100 100 0 102 102 102 0 0 0 0 0 0 0 0 102 102 102 0 100 100 0 102 0 100 102
102 100 0 102 0 100 100 0 102 102 102 0 0 0 0 0 0 0 2 102 102 102 0 100 100 0 102 0 100 102
102 100 0 102 0 100 100 0 102 102 102 102 102 102 102 102 102 102 100 102 102 102 0 100 100 0 102 0 100 102
102 100 0 102 0 100 100 0 102 102 102 102 102 102 102 102 102 102 100 102 102 102 0 100 100 0 102 0 100 102
102 100 0 102 0 100 100 0 102 102 102 102 102 102 102 102 102 102 100 102 102 102 0 100 100 0 102 0 100 102
102 100 0 102 0 100 100 0 0 0 0 0 0 0 0 0 0 102 100 102 0 0 0 100 100 0 102 0 100 102
102 100 0 102 0 100 100 0 100 100 100 100 100 100 100 100 0 102 100 102 0 100 100 100 100 0 102 0 100 102
102 100 0 102 0 100 100 0 100 100 100 100 100 100 100 100 0 102 100 102 0 100 100 100 100 0 102 0 100 102
102 100 0 102 0 0 0 0 0 0 0 0 0 0 0 0 0 0 0 0 0 0 0 0 0 0 102 0 100 102
102 100 0 102 102 102 102 102 102 102 102 102 102 102 102 102 102 102 102 102 102 102 102 102 102 102 102 0 100 102
102 100 0 0 0 0 0 0 0 0 0 0 0 0 0 0 0 0 0 0 0 0 0 0 0 0 0 0 100 102
102 100 100 100 100 100 100 100 100 100 100 100 100 100 100 100 100 100 100 100 100 100 100 100 100 100 100 100 100 102
102 102 102 102 102 102 102 102 102 102 102 102 102 102 102 102 102 102 102 102 102 102 102 102 102 102 102 102 102 102
