102 102 102 102 102 102 102 102 102 102 102 102 102 102 102 102 102 102 102 102 102 102 102 102 102 102 102 102 102 102 102 102
102 0 0 0 0 0 0 0 0 0 0 0 0 0 0 0 0 0 0 0 0 0 0 0 0 0 0 0 0 0 0 102
102 0 100 100 100 0 100 100 100 100 100 100 100 100 100 100 100 100 100 100 100 100 100 100 100 100 0 100 100 100 0 102
102 0 100 100 100 0 100 100 100 100 100 100 100 100 100 100 100 100 100 100 100 100 100 100 100 100 0 100 100 100 0 102
102 0 100 100 100 0 102 102 102 102 102 102 102 102 102 102 102 102 102 102 102 102 102 102 102 102 0 100 100 100 0 102
102 0 0 0 0 0 0 0 0 0 0 0 0 0 0 0 0 0 0 0 0 0 0 0 0 0 0 0 0 0 0 102
102 0 100 100 102 0 0 0 102 102 102 102 102 102 102 102 102 102 102 102 102 102 102 102 0 0 0 102 100 100 0 102
102 0 100 100 102 0 0 0 0 0 0 0 0 0 0 0 0 0 0 0 0 0 0 0 0 0 0 102 100 100 0 102
102 0 100 100 102 0 102 0 102 102 102 102 102 102 102 0 0 102 102 102 102 102 102 102 0 102 0 102 100 100 0 102
102 0 100 100 102 0 102 0 102 100 100 0 0 102 0 0 0 0 102 0 0 100 100 102 0 102 0 102 100 100 0 102
102 0 100 100 102 0 102 0 102 100 1 0 0 0 0 0 0 0 0 0 0 0 100 102 0 102 0 102 100 100 0 102
102 0 100 100 102 0 102 0 102 0 0 0 100 100 0 100 100 0 100 100 0 0 0 102 0 102 0 102 100 100 0 102
102 0 100 100 102 0 102 0 102 0 0 100 100 102 0 100 100 0 102 100 100 0 0 102 0 102 0 102 100 100 0 102
102 0 100 100 102 0 102 0 102 102 0 100 102 102 0 100 100 0 102 102 100 0 102 102 0 102 0 102 100 100 0 102
102 0 100 100 102 0 102 0 102 0 0 0 0 0 0 0 0 0 0 0 0 0 0 102 0 102 0 102 100 100 0 102
102 0 100 100 102 0 102 0 0 0 0 100 100 100 0 0 0 0 100 100 100 0 0 0 0 102 0 102 100 100 0 102
102 0 100 100 102 0 102 0 0 0 0 100 100 100 0 0 0 0 100 100 100 0 0 0 0 102 0 102 100 100 0 102
102 0 100 100 102 0 102 0 102 0 0 0 0 0 0 0 0 0 0 0 0 0 0 102 0 102 0 102 100 100 0 102
102 0 100 100 102 0 102 0 102 102 0 100 102 102 0 100 100 0 102 102 100 0 102 102 0 102 0 102 100 100 0 102
102 0 100 100 102 0 102 0 102 0 0 100 100 102 0 100 100 0 102 100 100 0 0 102 0 102 0 102 100 100 0 102
102 0 100 100 102 0 102 0 102 0 0 0 100 100 0 100 100 0 100 100 0 0 0 102 0 102 0 102 100 100 0 102
102 0 100 100 102 0 102 0 102 100 0 0 0 0 0 0 0 0 0 0 0 2 100 102 0 102 0 102 100 100 0 102
102 0 100 100 102 0 102 0 102 100 100 0 0 102 0 0 0 0 102 0 0 100 100 102 0 102 0 102 100 100 0 102
102 0 100 100 102 0 102 0 102 102 102 102 102 102 102 0 0 102 102 102 102 102 102 102 0 102 0 102 100 100 0 102
102 0 100 100 102 0 0 0 0 0 0 0 0 0 0 0 0 0 0 0 0 0 0 0 0 0 0 102 100 100 0 102
102 0 100 100 102 0 0 0 102 102 102 102 102 102 102 102 102 102 102 102 102 102 102 102 0 0 0 102 100 100 0 102
102 0 0 0 0 0 0 0 0 0 0 0 0 0 0 0 0 0 0 0 0 0 0 0 0 0 0 0 0 0 0 102
102 0 100 100 100 0 102 102 102 102 102 102 102 102 102 102 102 102 102 102 102 102 102 102 102 102 0 100 100 100 0 102
102 0 100 100 100 0 100 100 100 100 100 100 100 100 100 100 100 100 100 100 100 100 100 100 100 100 0 100 100 100 0 102
102 0 100 100 100 0 100 100 100 100 100 100 100 100 100 100 100 100 100 100 100 100 100 100 100 100 0 100 100 100 0 102
102 0 0 0 0 0 0 0 0 0 0 0 0 0 0 0 0 0 0 0 0 0 0 0 0 0 0 0 0 0 0 102
102 102 102 102 102 102 102 102 102 102 102 102 102 102 102 102 102 102 102 102 102 102 102 102 102 102 102 102 102 102 102 102
