100 100 100 100 0 102 102 102 102 102 0 201-8,2 0 0 201-8,2 0 0 201-8,2 0 0 201-8,2 0 0 201-8,2 0 0 201-8,2 0 110 0 102 102 102 102 102 102 102 0 120 0 201-1,2 0 0 201-1,2 0 0 201-1,2 0 0 201-1,2 0 0 201-1,2 0 0 201-1,2 0 102 102 102 102 102 0 100 100 100 100
100 100 100 100 0 303-8,9,10,304,12,13,14,16,19,20,22 102 102 102 102 0 0 0 0 0 0 0 0 0 0 0 0 0 0 0 0 0 0 110 0 102 102 102 102 102 102 102 0 120 0 0 0 0 0 0 0 0 0 0 0 0 0 0 0 0 0 0 102 102 102 102 303-1,2,3,4,5,6,7,15,17,18,21 0 100 100 100 100
100 100 100 100 0 102 102 102 102 102 0 0 0 102 102 102 102 102 102 102 102 102 102 102 102 102 102 102 102 0 102 102 102 102 102 102 102 0 102 102 102 102 102 102 102 102 102 102 102 102 102 102 102 102 0 0 0 102 102 102 102 102 0 100 100 100 100
100 100 100 100 0 0 102 102 102 102 0 201-19,2 0 102 100 100 100 100 100 100 100 100 100 100 100 100 0 0 110 0 102 102 102 102 102 102 102 0 120 0 0 100 100 100 100 100 100 100 100 100 100 100 100 102 0 201-17,2 0 102 102 102 102 0 0 100 100 100 100
100 100 100 100 0 0 102 102 102 102 0 0 0 102 100 100 100 100 100 100 100 100 100 100 100 100 0 0 110 0 102 102 102 102 102 102 102 0 120 0 0 100 100 100 100 100 100 100 100 100 100 100 100 102 0 0 0 102 102 102 102 0 0 100 100 100 100
100 100 100 100 0 0 102 102 102 102 0 0 0 102 100 100 100 100 100 100 100 100 100 100 100 100 0 0 110 0 102 102 102 102 102 102 102 0 120 0 0 100 100 100 100 100 100 100 100 100 100 100 100 102 0 0 0 102 102 102 102 0 0 100 100 100 100
100 100 100 100 0 0 102 102 102 102 0 201-19,2 0 102 0 0 0 0 0 0 0 0 0 0 0 0 0 0 110 0 102 102 102 102 102 102 102 0 120 0 0 0 0 0 0 0 0 0 0 0 0 0 0 102 0 201-17,2 0 102 102 102 102 0 0 100 100 100 100
100 100 100 100 0 0 102 102 102 102 0 0 0 102 0 201-9,2 0 0 201-9,2 0 0 201-9,2 0 0 201-9,2 0 0 102 102 102 102 102 102 102 102 102 102 102 102 102 0 0 201-2,2 0 0 201-2,2 0 0 201-2,2 0 0 201-2,2 0 102 0 0 0 102 102 102 102 0 0 100 100 100 100
100 100 100 100 0 0 102 102 102 102 0 0 0 102 0 0 0 0 0 0 0 0 0 0 0 0 0 102 102 0 0 0 100 100 100 0 0 0 102 102 0 0 0 0 0 0 0 0 0 0 0 0 0 102 0 0 0 102 102 102 102 0 0 100 100 100 100
100 100 100 100 0 0 102 102 102 102 0 201-19,2 0 102 0 201-9,2 0 102 102 102 102 102 102 102 102 102 0 102 0 0 200-2 0 100 100 100 0 200-2 0 0 102 0 102 102 102 102 102 102 102 102 102 0 201-2,2 0 102 0 201-17,2 0 102 102 102 102 0 0 100 100 100 100
0 0 0 0 0 0 102 102 102 102 0 0 0 102 0 0 0 102 0 0 0 0 0 0 0 102 0 102 102 0 0 0 100 100 100 0 0 0 102 102 0 102 0 0 0 0 0 0 0 102 0 0 0 102 0 0 0 102 102 102 102 0 0 0 0 0 0
110 102 303-14 303-19 102 303-22 102 102 102 102 0 0 0 102 0 201-9,2 0 102 0 102 102 102 102 102 110 102 0 102 0 0 200-2 0 101 102 101 0 200-2 0 0 102 0 102 120 102 102 102 102 102 0 102 0 201-2,2 0 102 0 0 0 102 102 102 102 303-21 102 303-17 303-7 102 120
110 102 102 102 102 102 102 102 102 102 0 201-19,2 0 102 0 0 0 102 0 102 102 0 0 0 0 0 0 102 102 0 0 0 101 102 101 0 0 0 102 102 0 0 0 0 0 0 102 102 0 102 0 0 0 102 0 201-17,2 0 102 102 102 102 102 102 102 102 102 120
110 102 102 102 102 102 102 102 102 102 0 0 0 102 110 102 102 102 110 102 102 0 200-2 0 0 201-10,2 0 102 0 0 200-2 0 101 102 101 0 200-2 0 0 102 0 201-3,2 0 0 200-2 0 102 102 120 102 102 102 120 102 0 0 0 102 102 102 102 102 102 102 102 102 120
110 102 102 102 102 102 102 102 102 102 110 110 110 102 110 102 102 102 110 102 102 0 0 0 0 0 0 102 102 0 0 0 101 102 101 0 0 0 102 102 0 0 0 0 0 0 102 102 120 102 102 102 120 102 120 120 120 102 102 102 102 102 102 102 102 102 120
0 0 0 0 0 0 0 110 110 110 110 110 110 110 0 102 304-5,11 102 0 102 102 102 110 0 0 201-10,2 0 102 0 0 200-2 0 101 102 101 0 200-2 0 0 102 0 201-3,2 0 0 120 102 102 102 0 102 304-61,11 102 0 120 120 120 120 120 120 120 0 0 0 0 0 0 0
0 201-14,2 0 201-14,2 0 201-14,2 0 102 102 102 100 100 0 102 0 201-22,2 110 201-22,2 0 303-8 102 102 0 110 0 0 0 102 102 0 0 0 101 102 101 0 0 0 102 102 0 0 0 120 0 102 102 303-1 0 201-21,2 120 201-21,2 0 102 0 100 100 102 102 102 0 201-7,2 0 201-7,2 0 201-7,2 0
0 0 0 0 0 0 0 102 102 102 100 100 0 102 0 0 0 0 0 303-9 102 102 0 0 110 0 0 102 0 0 200-2 0 101 102 101 0 200-2 0 0 102 0 0 120 0 0 102 102 303-2 0 0 0 0 0 102 0 100 100 102 102 102 0 0 0 0 0 0 0
0 201-14,2 0 201-14,2 0 201-14,2 0 102 102 102 100 100 0 102 102 0 0 0 0 303-10 102 102 0 0 201-16,3 110 0 101 101 0 0 0 101 102 101 0 0 0 101 101 0 120 201-15,3 0 0 102 102 303-3 0 0 0 0 102 102 0 100 100 102 102 102 0 201-7,2 0 201-7,2 0 201-7,2 0
0 0 0 0 0 0 0 102 102 102 100 100 0 102 303-16 0 0 0 1 0 110 110 0 0 0 0 110 102 0 0 200-2 0 101 102 101 0 200-2 0 0 102 120 0 0 0 0 120 120 0 2 0 0 0 303-15 102 0 100 100 102 102 102 0 0 0 0 0 0 0
0 201-14,2 0 201-14,2 0 201-14,2 0 102 102 102 100 100 0 102 102 0 0 0 0 303-304 102 102 0 0 201-16,3 110 0 101 101 0 0 0 101 102 101 0 0 0 101 101 0 120 201-15,3 0 0 102 102 303-4 0 0 0 0 102 102 0 100 100 102 102 102 0 201-7,2 0 201-7,2 0 201-7,2 0
0 0 0 0 0 0 0 102 102 102 100 100 0 102 0 0 0 0 0 303-12 102 102 0 0 110 0 0 102 0 0 200-2 0 101 102 101 0 200-2 0 0 102 0 0 120 0 0 102 102 303-5 0 0 0 0 0 102 0 100 100 102 102 102 0 0 0 0 0 0 0
0 201-14,2 0 201-14,2 0 201-14,2 0 102 102 102 100 100 0 102 0 201-22,2 110 201-22,2 0 303-13 102 102 0 110 0 0 0 102 102 0 0 0 101 102 101 0 0 0 102 102 0 0 0 120 0 102 102 303-6 0 201-21,2 120 201-21,2 0 102 0 100 100 102 102 102 0 201-7,2 0 201-7,2 0 201-7,2 0
0 0 0 0 0 0 0 110 110 110 110 110 110 110 0 102 304-5,27 102 0 102 102 102 110 0 0 201-11,2 0 102 0 0 200-2 0 101 102 101 0 200-2 0 0 102 0 201-4,2 0 0 120 102 102 102 0 102 304-61,27 102 0 120 120 120 120 120 120 120 0 0 0 0 0 0 0
110 102 102 102 102 102 102 102 102 102 110 110 110 102 110 102 102 102 110 102 102 0 0 0 0 0 0 102 102 0 0 0 101 102 101 0 0 0 102 102 0 0 0 0 0 0 102 102 120 102 102 102 120 102 120 120 120 102 102 102 102 102 102 102 102 102 120
110 102 102 102 102 102 102 102 102 102 0 0 0 102 110 102 102 102 110 102 102 0 200-2 0 0 201-304,2 0 102 0 0 200-2 0 101 102 101 0 200-2 0 0 102 0 201-4,2 0 0 200-2 0 102 102 120 102 102 102 120 102 0 0 0 102 102 102 102 102 102 102 102 102 120
110 102 102 102 102 102 102 102 102 102 0 201-20,2 0 102 0 0 0 102 0 102 102 0 0 0 0 0 0 102 102 0 0 0 101 102 101 0 0 0 102 102 0 0 0 0 0 0 102 102 0 102 0 0 0 102 0 201-18,2 0 102 102 102 102 102 102 102 102 102 120
110 102 303-14 303-20 102 303-22 102 102 102 102 0 0 0 102 0 201-12,2 0 102 0 102 102 102 102 102 110 102 0 102 0 0 200-2 0 101 102 101 0 200-2 0 0 102 0 102 120 102 102 102 102 102 0 102 0 201-5,2 0 102 0 0 0 102 102 102 102 303-21 102 303-18 303-7 102 120
0 0 0 0 0 0 102 102 102 102 0 0 0 102 0 0 0 102 0 0 0 0 0 0 0 102 0 102 102 0 0 0 100 100 100 0 0 0 102 102 0 102 0 0 0 0 0 0 0 102 0 0 0 102 0 0 0 102 102 102 102 0 0 0 0 0 0
100 100 100 100 0 0 102 102 102 102 0 201-20,2 0 102 0 201-12,2 0 102 102 102 102 102 102 102 102 102 0 102 0 0 200-2 0 100 100 100 0 200-2 0 0 102 0 102 102 102 102 102 102 102 102 102 0 201-5,2 0 102 0 201-18,2 0 102 102 102 102 0 0 100 100 100 100
100 100 100 100 0 0 102 102 102 102 0 0 0 102 0 0 0 0 0 0 0 0 0 0 0 0 0 102 102 0 0 0 100 100 100 0 0 0 102 102 0 0 0 0 0 0 0 0 0 0 0 0 0 102 0 0 0 102 102 102 102 0 0 100 100 100 100
100 100 100 100 0 0 102 102 102 102 0 0 0 102 0 201-12,2 0 0 201-12,2 0 0 201-12,2 0 0 201-12,2 0 0 102 102 102 102 102 102 102 102 102 102 102 102 102 0 0 201-5,2 0 0 201-5,2 0 0 201-5,2 0 0 201-5,2 0 102 0 0 0 102 102 102 102 0 0 100 100 100 100
100 100 100 100 0 0 102 102 102 102 0 201-20,2 0 102 0 0 0 0 0 0 0 0 0 0 0 0 0 0 110 0 102 102 102 102 102 102 102 0 120 0 0 0 0 0 0 0 0 0 0 0 0 0 0 102 0 201-18,2 0 102 102 102 102 0 0 100 100 100 100
100 100 100 100 0 0 102 102 102 102 0 0 0 102 100 100 100 100 100 100 100 100 100 100 100 100 0 0 110 0 102 102 102 102 102 102 102 0 120 0 0 100 100 100 100 100 100 100 100 100 100 100 100 102 0 0 0 102 102 102 102 0 0 100 100 100 100
100 100 100 100 0 0 102 102 102 102 0 0 0 102 100 100 100 100 100 100 100 100 100 100 100 100 0 0 110 0 102 102 102 102 102 102 102 0 120 0 0 100 100 100 100 100 100 100 100 100 100 100 100 102 0 0 0 102 102 102 102 0 0 100 100 100 100
100 100 100 100 0 0 102 102 102 102 0 201-20,2 0 102 100 100 100 100 100 100 100 100 100 100 100 100 0 0 110 0 102 102 102 102 102 102 102 0 120 0 0 100 100 100 100 100 100 100 100 100 100 100 100 102 0 201-18,2 0 102 102 102 102 0 0 100 100 100 100
100 100 100 100 0 102 102 102 102 102 0 0 0 102 102 102 102 102 102 102 102 102 102 102 102 102 102 102 102 0 102 102 102 102 102 102 102 0 102 102 102 102 102 102 102 102 102 102 102 102 102 102 102 102 0 0 0 102 102 102 102 102 0 100 100 100 100
100 100 100 100 0 303-8,9,10,304,12,13,14,16,19,20,22 102 102 102 102 0 0 0 0 0 0 0 0 0 0 0 0 0 0 0 0 0 0 110 0 102 102 102 102 102 102 102 0 120 0 0 0 0 0 0 0 0 0 0 0 0 0 0 0 0 0 0 102 102 102 102 303-1,2,3,4,5,6,7,15,17,18,21 0 100 100 100 100
100 100 100 100 0 102 102 102 102 102 0 201-13,2 0 0 201-13,2 0 0 201-13,2 0 0 201-13,2 0 0 201-13,2 0 0 201-13,2 0 110 0 102 102 102 102 102 102 102 0 120 0 201-6,2 0 0 201-6,2 0 0 201-6,2 0 0 201-6,2 0 0 201-6,2 0 0 201-6,2 0 102 102 102 102 102 0 100 100 100 100
