102 102 102 102 102 102 102 102 102 102 102 102 102102 0 100 0 100 0 1 0 100 0 100 0 102
102 0 100 0 100 0 100 0 100 0 100 0 102102 100 102 102 102 102 102 102 102 102 102 100 102
102 0 0 0 0 0 0 0 0 0 0 0 102
102 0 0 0 102 100 100 100 102 0 0 0 102102 100 102 102 102 100 100 100 102 102 102 100 102102 100 100 100 102 100 100 100 102 100 100 100 102102 100 100 100 100 100 100 100 100 100 100 100 102102 100 100 100 102 100 100 100 102 100 100 100 102102 100 102 102 102 100 100 100 102 102 102 100 102102 0 0 0 102 100 100 100 102 0 0 0 102102 0 0 0 0 0 0 0 0 0 0 0 102102 100 102 102 102 102 102 102 102 102 102 100 102
102 0 100 0 100 0 100 0 100 0 100 0 102102 0 100 0 100 0 2 0 100 0 100 0 102102 102 102 102 102 102 102 102 102 102 102 102 102
