102 102 102 102 102 102 102 102 102 102 102 102 102 102 102 102 102 102 102 102 102 102 102
102 100 100 100 100 100 100 100 100 102 102 102 102 102 100 100 100 100 100 100 100 100 102
102 100 0 0 0 0 0 1 100 102 102 102 102 102 100 2 0 0 0 0 0 100 102
102 100 0 100 100 100 100 100 100 102 102 102 102 102 100 100 100 100 100 100 0 100 102
102 100 0 102 102 102 102 102 102 102 102 102 102 102 102 102 102 102 102 102 0 100 102
102 100 0 102 102 102 102 102 102 102 102 102 102 102 102 102 102 102 102 102 0 100 102
102 100 0 102 102 0 0 0 0 200 0 0 0 200 0 0 0 0 102 102 0 100 102
102 100 0 102 102 102 0 200 0 0 0 200 0 0 0 200 0 102 102 102 0 100 102
102 100 0 101 102 200 0 0 0 200 0 0 0 200 0 0 0 200 102 101 0 100 102
102 100 0 101 101 0 0 200 0 0 0 200 0 0 0 200 0 0 101 101 0 100 102
102 100 0 101 102 200 0 0 0 200 0 0 0 200 0 0 0 200 102 101 0 100 102
102 100 0 102 102 102 0 200 0 0 0 200 0 0 0 200 0 102 102 102 0 100 102
102 100 0 102 102 0 0 0 0 200 0 0 0 200 0 0 0 0 102 102 0 100 102
102 100 0 102 102 102 102 102 102 102 102 102 102 102 102 102 102 102 102 102 0 100 102
102 100 0 102 102 102 102 102 102 102 102 102 102 102 102 102 102 102 102 102 0 100 102
102 100 0 0 0 0 0 0 0 102 102 102 102 102 0 0 0 0 0 0 0 100 102
102 100 0 102 102 102 102 102 110 102 102 102 102 102 120 102 102 102 102 102 0 100 102
102 100 0 102 100 100 100 100 0 102 102 102 102 102 0 100 100 100 100 102 0 100 102
102 100 0 102 100 200 100 100 0 102 102 102 102 102 0 100 100 200 100 102 0 100 102
102 100 0 102 100 100 100 100 0 102 102 102 102 102 0 100 100 100 100 102 0 100 102
102 100 0 102 100 100 100 100 0 102 102 102 102 102 0 100 100 100 100 102 0 100 102
102 100 0 102 100 100 100 100 0 102 102 102 102 102 0 100 100 100 100 102 0 100 102
102 100 0 102 100 100 100 100 0 102 102 102 102 102 0 100 100 100 100 102 0 100 102
102 100 0 102 100 200 100 100 0 102 102 102 102 102 0 100 100 200 100 102 0 100 102
102 100 0 102 100 100 100 100 0 102 102 102 102 102 0 100 100 100 100 102 0 100 102
102 100 0 102 102 102 102 102 110 102 102 102 102 102 120 102 102 102 102 102 0 100 102
102 100 0 0 0 0 0 0 0 102 102 102 102 102 0 0 0 0 0 0 0 100 102
102 102 102 102 102 102 102 102 102 102 102 102 102 102 102 102 102 102 102 102 102 102 102
